1 1 1 1 1 1 1 1 1 1 1 1 1 1 1 1 1 1 1 1 1 1 1 1 1 1 1 1 1 1 1 1 
1 1 1 1 1 1 1 1 1 4 4 4 4 4 1 1 1 1 4 4 4 4 4 1 1 1 1 1 1 1 1 1 
1 1 1 1 1 2 2 2 2 2 2 2 2 2 2 1 1 2 2 2 2 2 2 6 2 2 2 1 1 1 1 1 
1 1 2 2 2 5 5 5 2 5 5 5 2 2 1 1 1 1 2 2 5 5 5 2 2 2 2 2 2 2 1 1 
1 1 2 5 5 5 2 5 2 5 2 5 2 1 1 4 4 1 1 2 5 2 5 5 5 2 2 2 2 2 1 1 
2 2 2 5 2 2 2 5 2 5 2 5 2 1 4 2 2 4 1 2 5 2 2 2 5 2 2 2 2 2 2 2 
5 5 5 5 2 5 5 5 2 5 2 5 5 5 5 5 5 5 5 5 5 2 5 5 5 2 2 2 5 2 2 2 
2 2 2 2 2 5 2 2 2 5 2 2 2 1 4 2 2 4 1 2 2 2 5 2 2 2 2 2 5 2 2 2 
1 1 2 6 2 5 2 2 2 5 2 6 2 1 1 4 4 1 1 2 2 2 5 2 2 5 5 5 5 2 1 1 
1 1 2 2 2 5 5 5 5 5 2 2 2 4 1 1 1 1 4 2 2 6 5 5 5 5 2 2 2 2 1 1 
3 3 3 3 3 2 2 2 2 2 2 2 2 2 4 1 1 4 2 2 2 2 2 2 2 2 2 3 3 3 3 3 
3 3 3 3 3 3 3 3 3 2 2 2 2 4 1 1 1 1 4 2 2 2 2 3 3 3 3 3 3 3 3 3 
3 3 3 3 3 3 3 3 3 3 3 3 1 1 1 1 1 1 1 1 3 3 3 3 3 3 3 3 3 3 3 3 
3 3 3 3 3 3 6 3 3 3 3 3 1 1 1 1 1 1 1 1 3 3 3 3 3 3 3 3 3 3 3 3 
3 3 3 3 3 3 3 3 3 3 3 3 1 1 1 1 1 1 1 1 3 3 3 3 6 3 3 3 3 3 3 3 
3 3 3 3 3 3 3 3 3 3 3 3 1 1 1 1 1 1 1 1 3 3 3 3 3 3 3 3 3 3 3 3 
